arrival	(n.) 到達、到來、達到
bulky	(adj.) 體積大的、龐大的、笨重的
clarification	(n.) 澄清、淨化、澄清法
criticize	(v.) 批評、評論、評價
digital	(adj.) 數字的、指的 (n.) 鍵
expandable	(adj.) 可擴大的、可擴展的
fast-forward	(v.) 快轉、快進
import	(v.) 進口、輸入、引進
intercom	(n.) 對講機
knoll	(n.) 圓丘、小丘、土墩
mad	(adj.) 發瘋的、狂熱的、著迷的
motel	(n.) 汽車旅館
office	(n.) 辦公室、營業處所
part-time	(adj.) 兼職的、部份時間的
profitable	(adj.) 有利的、有利可圖的
release	(v.) 釋放、解放、鬆開
season	(n.) 季節、時令 (v.) 調味
spicy	(adj.) 辛辣的、有加香料的
trader	(n.) 商人、買賣人、經商者
versatile	(adj.) 多才多藝的、多樣的、多功能的